Von -I
Modr - You
Port - she
Port - he
Port - it
Aniv - animal
Anivǎ - cat
Anivě - dog
Anivǔ - meat
Mart - plant
Martǎ - tree
Martŭ - food
Panū - liquid/water
Gaba - place
Naaniv - human
Naanivě - man/boy
Naanivǎ - woman/girl
Quat - chiken
Quer - pig
Quan - cow
Gabahorlīnǐ - home/house
Sero - 0
Raf - 1
Traf - 2
Turaf - 3
Furaf - 4
Fur - 5
Furan - 6
Sedum - 7
Sedom - 8
Ded - 9
Dedum - 10
Anno - year
Loquǐhormoga - language
Sona - sun/day
Mona - moon
Keki - time
Sonahorkeki - day (polite)
Monahorkeki - night
Iuna - Hi (casual)
Sonahoriuna - Hello (polite, said 8:00-21:30)
Monahoriuna - Hello (polite, said 21:31-7:59)
Pā - bye (very casual)
Mogayahorpā - goodbye (very polite)
Mogayanā - thank you (polite)
Gataīhorgaba - shop
Sorweq - work
Sorweqhorgaba - work (place)/office/agency
Sorweqhornaaniv - worker
barum - Because
Pāω - Get the fuck out
Modr na ω - Fuck you
Sona = Day of the week
Man - month
Mater - mom
Pater - dad
Soror - sister
Frater - brother
Oma - grandma
Opa - grandpa
Nahara - Aunt/uncle/cousin
Natadi - birthday 
Puta - thing
Natadihorputa - present
Kaki - What
Keki - Where
Kuki - How
Kiki - When
Kēkē - Whatever 
Pen - pen
Penicillus - pencil
Leger - book
Lenǐ - to read
Scribtǐ - to write
Uban - clothes
Nom - noun
Verb - verb/do
Lǐnīhorverb - sex
Anǎl - anal sex
Orǎl - oral sex
Ami - love (noun)
Mart - plant
Martǎ - tree
Martě - grass
Gurt - mountain
Gurthormart - hill
Martŭhorgaba - field
Martǎhorgaba - forest
Arai - red
Barai - blue
Garai - green
Narai - yellow
Gurai - grey
Guraiǎ - white
Guraiě - black
Maga - magenta
Magaǎ - pink 
Magaě - purple
Huraī - chess
Kurten - knight
Sort - sword
Lant - shield
Mrant - armor
Manarō - fight
Turtǐ - sword fight for points (often used to end disputes)
Illi - illnes
Qunok - broken
Mana - head/brain
Arh - arm
Bond - leg
Mrantan - chest (body part)
Orti - organ
Nar - nose
Narǐ - to smell
Pur - ear
Purǐ - to hear
Luk - eye
Lukǐ - to see
Vana - vagina
Penis - penis
Putf - ass
Odor - music/song